||||||||||||||||||||||||||||
|......||..........||......|
|.||||.||.||||||||.||.||||.|
|.||||.||.||||||||.||.||||.|
|..........................|
|||.||.|||||.||.|||||.||.|||
|||.||.|___|.||.|___|.||.|||
|||.||.|||||.||.|||||.||.|||
....||.......||.......||.|||
|||.|||||.||||||||.|||||.|__
__|.|||||.||||||||.|||||.|__
__|......................|__
__|.|||||.|||--|||.|||||.|__
__|.||....|******|....||.|__
__|.||.||.|******|.||.||.|__
__|.||.||.|******|.||.||.|__
__|.||.||.||||||||.||.||.|||
__|....||..........||.......
__|.||||||||.||.||||||||.|||
__|.||||||||.||.||||||||.|__
__|..........||..........|__
__|.|||||.||||||||.|||||.|__
|||.|||||.||||||||.|||||.|||
|..........................|
|.||||.|||||.||.|||||.||||.|
|.|__|.|||||.||.|||||.|__|.|
|.|__|.||....||....||.|__|.|
|.|__|.||.||||||||.||.|__|.|
|.||||.||.||||||||.||.||||.|
|..........................|
||||||||||||||||||||||||||||